//
// This file is part of plata-theme
//
// Copyright (C) 2018-2020 Tista <tista.gma500@gmail.com>
//
// This program is free software; you can redistribute it and/or modify
// it under the terms of the GNU General Public License as published by
// the Free Software Foundation; either version 2 of the License, or
// (at your option) any later version.
//

//
// colors for dark-variant
//

FG_COLOR: #F5F5F5;                              // Main foreground color
SECONDARY_FG_COLOR: #F5F5F5DE;                  // Secondary foreground color (87%)
TERTIARY_FG_COLOR: #F5F5F58A;                   // Tertiary foreground color (54%)
INSENSITIVE_FG_COLOR: #F5F5F547;                // Insensitive foreground color (28%)
SELECTED_FG_COLOR: #FFFFFF;                     // Selected foreground color
2ND_SELECTED_FG_COLOR: #FFFFFFDE;               // Secondary selected foreground color (87%)
OSD_FG_COLOR: #F5F5F5;                          // Tooltip foreground color
PLACEHOLDER_COLOR: #616161;                     // Placeholder foreground color
FIXED_SECONDARY_FG_COLOR: #111111DE;            // Dark foreground color in dark variant (87%)

ACCENT_LABEL_COLOR: @ACC_FG@;                    // Action-area foreground color
2ND_ACCENT_LABEL_COLOR: @ACC_FG@DE;              // Secondary action-area foreground color (87%)

BG_COLOR: #1D1D1D;                              // Main background color
BASE_COLOR: #111111;                            // Entry/Notebook background color
DARK_COLOR: #080808;                            // WindowFrame/Popover/Inline-toolbar background color

SEMI_FILL_COLOR: #373737;                       // Hovered button background color (Bg + 12%)
FILL_COLOR: #535353;                            // Active button/ripple background color (Bg + 25%)
ACCENT_FILL_COLOR: @ACC_FILL1@;                     // Hovered button accent color (Bg + 12%)
ACCENT_ACTIVE_FILL_COLOR: @ACC_FILL2@;              // Active button/ripple accent color (Bg + 25%)
OSD_BG_COLOR: #080808ED;                        // OSD background color (93%)
TOOLTIP_BG_COLOR: #424242ED;                    // Tooltip background color (93%)
SUGGESTED_HOVER_COLOR: @SGT_FILL1@;                 // Hovered suggested action color
SUGGESTED_ACTIVE_COLOR: @SGT_FILL2@;                // Active/ripple suggested action color
DESTRUCTIVE_FILL_COLOR: @DST_FILL1@;                 // Hovered destructive action color (Bg + 12%)
DESTRUCTIVE_ACTIVE_FILL_COLOR: @DST_FILL2@;          // Active/ripple destructive action color (Bg + 25%)

SELECTED_BG_COLOR: @SEL_BG@;                     // Primary color
ACCENT_COLOR: @ACC_BG@;                          // Secondary color
SUGGESTED_COLOR: @SGT_BG@;                       // Suggested action color
DESTRUCTIVE_COLOR: @DST_BG@;                     // Destructive action color
LINK_COLOR: #52B2FF;
WARNING_COLOR: #FF9800;
ERROR_COLOR: #F44336;
SUCCESS_COLOR: #4CAF50;

SOLID_BLACK: #000000;
70_BLACK: #000000B2;                            // Deep shadows (70%)
50_BLACK: #00000080;                            // Medium shadows (50%)
30_BLACK: #0000004D;                            // Light shadows (30%)
10_BLACK: #0000001A;                            // Frames and separator color (10%)
TRANSPARENT: #00000000;
SOLID_WHITE: #FFFFFF;
RED: #F44336;
YELLOW: #FFEB3B;
GREEN: #4CAF50;
BLUE: #2196F3;

SCROLLBAR_BG: #1111118A;                        // Trough color (54%)
SCROLLBAR_SLIDER_BG: #F5F5F52A;                 // Slider color (29%)
SCROLLBAR_SLIDER_HOVER_BG: #F5F5F578;           // Hovered slider color (47%)

//
// basic
//

windowBg: BG_COLOR;                             // Window backgrounds
windowFg: FG_COLOR;                             // Main text / chat text
windowBgOver: SEMI_FILL_COLOR;                  // Search field background + buttons color in context menu
windowBgRipple: FILL_COLOR;                     // Inactive chat in chats list (press & hold)
windowFgOver: windowFg;                         // black: fallback for over text color
windowSubTextFg: TERTIARY_FG_COLOR;             // Chats list message preview text
windowSubTextFgOver: SECONDARY_FG_COLOR;        // Mouse over chats list message preview text
windowBoldFg: SECONDARY_FG_COLOR;               // Bold font (titles in Settings, Left menu options)
windowBoldFgOver: FG_COLOR;                     // Mouse over chats list chat name text (+ Left menu options on hover)
windowBgActive: SELECTED_BG_COLOR;              // Active button background (+ checkboxes background)
windowFgActive: SELECTED_FG_COLOR;              // Active selected chats list text / button text + checkboxes' "ticks" color
windowActiveTextFg: LINK_COLOR;                 // Online status, links, recording cancel, etc
windowShadowFg: SOLID_BLACK;                    // Window border shadows
windowShadowFgFallback: 10_BLACK;               // Notification border

shadowFg: 10_BLACK;                             // Internal border shadows
slideFadeOutBg: 30_BLACK;
slideFadeOutShadowFg: windowShadowFg;           // Window slide animation shadow

imageBg: SOLID_BLACK;
imageBgTransparent: SOLID_WHITE;

//
// widgets
//

activeButtonBg: SUGGESTED_COLOR;                // Currently selected button background
activeButtonBgOver: SUGGESTED_HOVER_COLOR;      // Mouse over currently selected button background
activeButtonBgRipple: SUGGESTED_ACTIVE_COLOR;   // Primary button background color (and active chat) - Press & hold 
activeButtonFg: 2ND_SELECTED_FG_COLOR;          // Currently selected button text
activeButtonFgOver: SELECTED_FG_COLOR;          // Mouse over currently selected button text
activeButtonSecondaryFg: SECONDARY_FG_COLOR;    // Counter color on primary button
activeButtonSecondaryFgOver: FG_COLOR;          // Counter color on primary button (hover)
activeLineFg: SELECTED_BG_COLOR;                // Active input field line color (normal)
activeLineFgError: ERROR_COLOR;                 // Active input field line color (error)

lightButtonBg: BG_COLOR;                        // Secondary button background color (default)
                                                // FIXME: do not use alpha-blended Bg colours
lightButtonBgOver: ACCENT_FILL_COLOR;           // Secondary button background color (hover)
lightButtonBgRipple: ACCENT_ACTIVE_FILL_COLOR;  // Secondary button background color (press & hold)
lightButtonFg: 2ND_ACCENT_LABEL_COLOR;          // Secondary button text color
lightButtonFgOver: ACCENT_LABEL_COLOR;

attentionButtonFg: DESTRUCTIVE_COLOR;
attentionButtonFgOver: DESTRUCTIVE_COLOR;
attentionButtonBgOver: DESTRUCTIVE_FILL_COLOR;
attentionButtonBgRipple: DESTRUCTIVE_ACTIVE_FILL_COLOR;

outlineButtonBg: lightButtonBg;                 // Buttons background in profiles (shared media)
outlineButtonBgOver: lightButtonBgOver;
outlineButtonOutlineFg: windowBgActive;
outlineButtonBgRipple: lightButtonBgRipple;

menuBg: BG_COLOR;                               // FIXME: secondary_base_color is more better...
menuBgOver: SEMI_FILL_COLOR;
menuBgRipple: FILL_COLOR;
menuIconFg: TERTIARY_FG_COLOR;                  // Icons color (left menu button, scroll down, paperclip..)
menuIconFgOver: SECONDARY_FG_COLOR;             // Icons color on hover (left menu button, scroll down, paperclip..)
menuSubmenuArrowFg: SECONDARY_FG_COLOR;
menuFgDisabled: INSENSITIVE_FG_COLOR;
menuSeparatorFg: 10_BLACK;

scrollBarBg: SCROLLBAR_SLIDER_BG;               // Scrollbar (chats list) current position
scrollBarBgOver: SCROLLBAR_SLIDER_HOVER_BG;     // Mouse over scrollbar (chats list) current position
scrollBg: SCROLLBAR_BG;                         // Scrollbar (chats list) background
scrollBgOver: SCROLLBAR_BG;                     // Mouse over scrollbar (chats list) background

smallCloseIconFg: SECONDARY_FG_COLOR;
smallCloseIconFgOver: FG_COLOR;

radialFg: ACCENT_COLOR;
radialBg: 30_BLACK;

placeholderFg: PLACEHOLDER_COLOR;               // Inactive input box placeholder text
placeholderFgActive: SECONDARY_FG_COLOR;        // Active input box placeholder text
inputBorderFg: 10_BLACK;
filterInputBorderFg: 10_BLACK;                  // Search field border
filterInputInactiveBg: DARK_COLOR;
checkboxFg: FG_COLOR;

sliderBgInactive: INSENSITIVE_FG_COLOR;         // Inactive media player button (prev/next song)
sliderBgActive: ACCENT_COLOR;                   // Active media player button (prev/next song)

tooltipBg: TOOLTIP_BG_COLOR;
tooltipFg: OSD_FG_COLOR;
tooltipBorderFg: TOOLTIP_BG_COLOR;

// custom title bar for Windows and macOS
titleBg: DARK_COLOR;                            // Title bar
titleShadow: 10_BLACK;
titleButtonFg: SECONDARY_FG_COLOR;              // Title bar buttons(min/max/close)
titleButtonBgOver: SEMI_FILL_COLOR;             // Title bar min/max background (hover)
titleButtonFgOver: FG_COLOR;                    // Title bar min/max icons 
titleButtonBgActive: titleButtonBg;
titleButtonFgActive: titleButtonFg;
titleButtonBgActiveOver: titleButtonBgOver;
titleButtonFgActiveOver: titleButtonFgOver;
titleButtonCloseBg: titleButtonBg;
titleButtonCloseFg: titleButtonFg;
titleButtonCloseBgOver: DESTRUCTIVE_COLOR;
titleButtonCloseFgOver: SELECTED_FG_COLOR;
titleButtonCloseBgActive: titleButtonCloseBg;
titleButtonCloseFgActive: titleButtonCloseFg;
titleButtonCloseBgActiveOver: titleButtonCloseBgOver;
titleButtonCloseFgActiveOver: titleButtonCloseFgOver;
titleFgActive: FG_COLOR;                        // Active title bar text (Mac)
titleFg: INSENSITIVE_FG_COLOR;                  // Inactive title bar text (Mac)

// tray icon
trayCounterBg: ERROR_COLOR;                     // Unread messages counter background in tray (not muted, default red)
trayCounterBgMute: DARK_COLOR;                  // Unread messages counter background in tray (muted, default gray)
trayCounterFg: SECONDARY_FG_COLOR;              // Unread messages counter text (number)
trayCounterBgMacInvert: SOLID_WHITE;            
trayCounterFgMacInvert: SOLID_WHITE;

// layers
layerBg: 50_BLACK;

cancelIconFg: menuIconFg;
cancelIconFgOver: menuIconFgOver;

// boxes
boxBg: windowBg;                                // Popup windows background color
boxTextFg: windowFg;                            // Popup windows text color
boxTextFgGood: SUCCESS_COLOR;                   // Popup windows "good" text (e.g. "Username available")
boxTextFgError: ERROR_COLOR;                    // Popup windows "bad" text (e.g. "Username already taken")
boxTitleFg: TERTIARY_FG_COLOR;                  // Popup windows titles color (sessions, contacts...)
boxSearchBg: boxBg;
boxSearchCancelIconFg: cancelIconFg;
boxSearchCancelIconFgOver: cancelIconFgOver;

boxTitleAdditionalFg: TERTIARY_FG_COLOR;
boxTitleCloseFg: ACCENT_COLOR;
boxTitleCloseFgOver: boxTitleCloseFg;

membersAboutLimitFg: windowSubTextFgOver;

contactsBg: windowBg;                           // Contacts list background color
contactsBgOver: windowBgOver;                   // Contacts list mouse over background
contactsNameFg: FG_COLOR;
contactsStatusFg: TERTIARY_FG_COLOR;            // Contacts list last seen
contactsStatusFgOver: windowSubTextFgOver;
contactsStatusFgOnline: windowActiveTextFg;

photoCropFadeBg: layerBg;                       // "Out-of-bounds" area in photo cropping (avatars etc...)
photoCropPointFg: ACCENT_COLOR;                 // Photo crop "corners" (which you drag to crop photo)
 
// intro
introBg: windowBg;
introTitleFg: windowBoldFg;
introDescriptionFg: TERTIARY_FG_COLOR;
introErrorFg: ERROR_COLOR;

introCoverTopBg: SUGGESTED_COLOR;               // These lines refer to Telegram "plane" logo...
introCoverBottomBg: SUGGESTED_COLOR;            // ... on "startup" screen, before entering phone number...
introCoverIconsFg: FG_COLOR;                    // ... unfortunately, this requires lots of logouts and logins...
introCoverPlaneTrace: SUGGESTED_ACTIVE_COLOR;   // ... so not possible to test this. Sorry!
introCoverPlaneInner: TRANSPARENT;
introCoverPlaneOuter: TRANSPARENT;
introCoverPlaneTop: SUGGESTED_HOVER_COLOR;

// dialogs
dialogsMenuIconFg: menuIconFg;
dialogsMenuIconFgOver: menuIconFgOver;

dialogsBg: BG_COLOR;                            // Chats list background color
dialogsNameFg: FG_COLOR;
dialogsChatIconFg: dialogsNameFg;
dialogsDateFg: TERTIARY_FG_COLOR;               // Chats list date text
dialogsTextFg: dialogsDateFg;                   // Chats list message preview text
dialogsTextFgService: windowActiveTextFg;       // Chats list message preview sender name
dialogsDraftFg: WARNING_COLOR;                  // "Draft" word
dialogsVerifiedIconBg: windowBgActive;          // Verification icon background
dialogsVerifiedIconFg: windowFgActive;          // Verification icon check color
dialogsSendingIconFg: INSENSITIVE_FG_COLOR;
dialogsSentIconFg: TERTIARY_FG_COLOR;
dialogsUnreadBg: SUGGESTED_COLOR;               // Chats list unread counter background
dialogsUnreadBgMuted: FILL_COLOR;               // Unread counter (for muted chats) + pins color(?)
dialogsUnreadFg: FG_COLOR;                      // Unread counter text color

dialogsBgOver: SEMI_FILL_COLOR;                 // Inactive chat color on hover
dialogsNameFgOver: FG_COLOR;
dialogsChatIconFgOver: dialogsNameFgOver;
dialogsDateFgOver: windowSubTextFgOver;
dialogsTextFgOver: windowSubTextFgOver;
dialogsTextFgServiceOver: dialogsTextFgService; // Mouse over chats list message preview sender name
dialogsDraftFgOver: dialogsDraftFg;
dialogsVerifiedIconBgOver: dialogsVerifiedIconBg;
dialogsVerifiedIconFgOver: dialogsVerifiedIconFg;
dialogsSendingIconFgOver: dialogsSendingIconFg;
dialogsSentIconFgOver: dialogsSentIconFg;
dialogsUnreadBgOver: dialogsUnreadBg;
dialogsUnreadBgMutedOver: dialogsUnreadBgMuted;
dialogsUnreadFgOver: dialogsUnreadFg;

dialogsBgActive: SELECTED_BG_COLOR;             // Active chat color (in chats list)
dialogsNameFgActive: SELECTED_FG_COLOR;
dialogsChatIconFgActive: dialogsNameFgActive;
dialogsDateFgActive: FIXED_SECONDARY_FG_COLOR;  // Selected sub label color
dialogsTextFgActive: dialogsDateFgActive;
dialogsTextFgServiceActive: dialogsTextFgActive;
dialogsDraftFgActive: WARNING_COLOR;            // "Draft" word when chat is selected
dialogsVerifiedIconBgActive: dialogsTextFgActive;
dialogsVerifiedIconFgActive: dialogsBgActive;
dialogsSendingIconFgActive: FG_COLOR;
dialogsSentIconFgActive: dialogsTextFgActive;
dialogsUnreadBgActive: dialogsTextFgActive;
dialogsUnreadBgMutedActive: dialogsDraftFgActive;
dialogsUnreadFgActive: dialogsBgActive;

dialogsForwardBg: dialogsBgActive;
dialogsForwardFg: dialogsNameFgActive;

searchedBarBg: DARK_COLOR;                      // Search results window background color
searchedBarFg: FG_COLOR;                        // Search results text color

// history
topBarBg: BG_COLOR;                             // Chat header background
emojiPanBg: DARK_COLOR;                         // Sticker panel background
emojiPanCategories: DARK_COLOR;                 // Sticker panel bottom bar background
emojiPanHeaderFg: FG_COLOR;                     // Sticker panel title text
emojiPanHeaderBg: DARK_COLOR;                   // Sticker panel top bar background
stickerPanDeleteBg: SEMI_FILL_COLOR;
stickerPanDeleteFg: FG_COLOR;
stickerPreviewBg: OSD_BG_COLOR;                 // Sticker preview background

historyTextInFg: SECONDARY_FG_COLOR;            // Incoming messages TEXT color
historyTextOutFg: FG_COLOR;                     // Outgoing messages TEXT color
historyTextInFgSelected: SELECTED_FG_COLOR;
historyTextOutFgSelected: SELECTED_FG_COLOR;    // outbox message selected text or text in a selected message
historyLinkInFg: LINK_COLOR;                    // inbox message link
historyLinkInFgSelected: DARK_COLOR;            // inbox message link in a selected text or message
historyLinkOutFg: LINK_COLOR;                   // outbox message link
historyLinkOutFgSelected: DARK_COLOR;           // outbox message link in a selected text or message

historyFileNameInFg: historyTextInFg;
historyFileNameInFgSelected: BASE_COLOR;        // inbox media filename text in a selected message
historyFileNameOutFg: historyTextOutFg;
historyFileNameOutFgSelected: BASE_COLOR;       // outbox media filename text in a selected message

historyOutIconFg: dialogsSentIconFg;            // "Eye" and "Ticks" color for outgoing messages (selected)
historyOutIconFgSelected: SELECTED_BG_COLOR;    // "Eye" and "Ticks" color for outgoing messages (selected)
historyIconFgInverted: SELECTED_FG_COLOR;
historySendingOutIconFg: ACCENT_LABEL_COLOR;    // "Clock" icon while sending file (outgoing)
historySendingInIconFg: ACCENT_LABEL_COLOR;     // "Clock" icon while sending file (incoming)
historySendingInvertedIconFg: SELECTED_FG_COLOR;

historyUnreadBarBg: DARK_COLOR;                 // Unread messages bar color
historyUnreadBarBorder: 10_DARK;
historyUnreadBarFg: FG_COLOR;

historyForwardChooseBg: 30_BLACK;               // "Choose recipient" BACKGROUND color (forwarding)
historyForwardChooseFg: FG_COLOR;               // "Choose recipient" TEXT color (forwarding)

historyPeer1NameFg: #ff9100;                    // Group chat sender name - Orange
historyPeer1UserpicBg: #e17076;
historyPeer2NameFg: #4fad2d;                    // Green
historyPeer2UserpicBg: #7bc862;
historyPeer3NameFg: #d09306;                    // Gold
historyPeer3UserpicBg: #e5ca77;
historyPeer4NameFg: #15cd7d;                    // Light green
historyPeer4UserpicBg: #65aadd;
historyPeer5NameFg: #9a4ff7;                    // Violet
historyPeer5UserpicBg: #a695e7;
historyPeer6NameFg: #cd4073;                    // "Raspberry"
historyPeer6UserpicBg: #ee7aae;
historyPeer7NameFg: #2996ad;                    // Cyan
historyPeer7UserpicBg: #6ec9cb;
historyPeer8NameFg: #ce671b;                    // One more orange?!
historyPeer8UserpicBg: #faa774;
historyPeerUserpicFg: SOLID_WHITE;

historyScrollBarBg: scrollBarBg;                // Scrollbar (history view) background
historyScrollBarBgOver: scrollBarBgOver;        // Scrollbar (history view) background (hover)
historyScrollBg: scrollBg;                      // Scrollbar (history view) current position background
historyScrollBgOver: scrollBgOver;              // Scrollbar (history view) current position background (hover)

// FIXME: untouched yet
msgInBg: BASE_COLOR;                            // Incoming message background
msgInBgSelected: SELECTED_BG_COLOR;             // Selected incoming message background
msgOutBg: BG_COLOR;                             // Outgoing message background
msgOutBgSelected: SELECTED_BG_COLOR;            // Selected outgoing message background
msgSelectOverlay: 50_BLACK;                     // Selected media (images...) overlay
msgStickerOverlay: 50_BLACK;                    // Selected sticker overlay
msgInServiceFg: windowActiveTextFg;             // Incoming reply quoted name
msgInServiceFgSelected: windowActiveTextFg;     // Selected incoming reply quoted name
msgOutServiceFg: FG_COLOR;                      // Outgoing reply quoted name
msgOutServiceFgSelected: SELECTED_FG_COLOR;     // Selected outgoing reply quoted name
msgInShadow: 10_BLACK;                          // Incoming message box shadow
msgInShadowSelected: 30_BLACK;                  // Selected incoming message box shadow
msgOutShadow: 10_BLACK;                         // Outgoing message box shadow
msgOutShadowSelected: 30_BLACK;                 // Selected outgoing message box shadow
msgInDateFg: TERTIARY_FG_COLOR;                 // Incoming message date text
msgInDateFgSelected: SELECTED_FG_COLOR;
msgOutDateFg: TERTIARY_FG_COLOR;                // Outgoing message date text
msgOutDateFgSelected: SELECTED_BG_COLOR;
msgServiceFg: FG_COLOR;                         // Service messages TEXT color (join, left etc)
msgServiceBg: OSD_BG_COLOR;                     // Service messages BACKGROUND color (join, left etc)
msgServiceBgSelected: SELECTED_BG_COLOR;
msgInReplyBarColor: SUGGESTED_COLOR;            // Incoming msg: vertical bar next to reply
msgInReplyBarSelColor: SUGGESTED_COLOR;         // Incoming msg: vertical bar next to reply (selected)
msgOutReplyBarColor: SUGGESTED_COLOR;           // Outgoing msg: vertical bar next to reply
msgOutReplyBarSelColor: SUGGESTED_COLOR;        // Outgoing msg: vertical bar next to reply (selected)
msgInMonoFg: ACCENT_COLOR;                      // Fixedwidth font / incoming msg
msgInMonoFgSelected: BG_COLOR;                  // inbox message monospace text in a selected text or message
msgOutMonoFg: ACCENT_COLOR;                     // Fixedwidth font / outgoing msg
msgOutMonoFgSelected: BG_COLOR;                 // outbox message monospace text in a selected text or message

msgDateImgFg: msgServiceFg;						
msgDateImgBg: OSD_BG_COLOR;                     // Download / play / etc overlay backgrounds
msgDateImgBgOver: OSD_BG_COLOR;                 // Mouse over download / play / etc overlay backgrounds
msgDateImgBgSelected: SELECTED_BG_COLOR;

msgFileThumbLinkInFg: lightButtonFg;
msgFileThumbLinkInFgSelected: SELECTED_FG_COLOR;
msgFileThumbLinkOutFg: lightButtonFg;
msgFileThumbLinkOutFgSelected: SELECTED_FG_COLOR;
msgFileInBg: BG_COLOR;
msgFileInBgOver: BASE_COLOR;
msgFileInBgSelected: SELECTED_BG_COLOR;
msgFileOutBg: msgFileInBg;
msgFileOutBgOver: msgFileInBgOver;
msgFileOutBgSelected: msgFileInBgSelected;

msgFile1Bg: #72b1df;
msgFile1BgDark: #5c9ece;
msgFile1BgOver: #5294c4;
msgFile1BgSelected: #5099d0;
msgFile2Bg: #61b96e;
msgFile2BgDark: #4da859;
msgFile2BgOver: #44a050;
msgFile2BgSelected: #46a07e;
msgFile3Bg: #e47272;
msgFile3BgDark: #cd5b5e;
msgFile3BgOver: #c35154;
msgFile3BgSelected: #9f6a82;
msgFile4Bg: #efc274;
msgFile4BgDark: #e6a561;
msgFile4BgOver: #dc9c5a;
msgFile4BgSelected: #b19d84;

historyFileInIconFg: FG_COLOR;                     // Uploading/downloading icons?
historyFileInIconFgSelected: SELECTED_FG_COLOR;
historyFileInRadialFg: ACCENT_COLOR;
historyFileInRadialFgSelected: SELECTED_FG_COLOR;
historyFileOutIconFg: historyFileInIconFg;
historyFileOutIconFgSelected: historyFileInIconFgSelected;
historyFileOutRadialFg: historyFileInIconFg;
historyFileOutRadialFgSelected: historyFileInIconFgSelected;
historyFileThumbIconFg: ACCENT_COLOR;
historyFileThumbIconFgSelected: SOLID_WHITE;
historyFileThumbRadialFg: ACCENT_COLOR;
historyFileThumbRadialFgSelected: SOLID_WHITE;

msgWaveformInActive: windowBgActive;               // Incoming Voice "heard" part
msgWaveformInActiveSelected: SELECTED_BG_COLOR;    // Selected incoming Voice "heard" part
msgWaveformInInactive: INSENSITIVE_FG_COLOR;       // Incoming Voice "unheard" part
msgWaveformInInactiveSelected: SECONDARY_FG_COLOR; // Selected incoming Voice "unheard" part
msgWaveformOutActive: windowBgActive;              // Outgoing Voice "heard" part
msgWaveformOutActiveSelected: SELECTED_BG_COLOR;   // Selected outgoing Voice "heard" part
msgWaveformOutInactive: FG_COLOR;                  // Outgoing Voice "unheard" part
msgWaveformOutInactiveSelected: SELECTED_FG_COLOR; // Selected outgoing Voice "unheard" part

msgBotKbOverBgAdd: BG_COLOR;                     // Inline button (hover)
msgBotKbIconFg: FG_COLOR;                        // Inline button icon color (URL Buttons, for example)
msgBotKbRippleBg: FILL_COLOR;                    // Inline button (press & hold)

mediaInFg: msgInDateFg;
mediaInFgSelected: msgInDateFgSelected;
mediaOutFg: msgOutDateFg;
mediaOutFgSelected: msgOutDateFgSelected;

youtubePlayIconBg: OSD_BG_COLOR;
youtubePlayIconFg: FG_COLOR;
videoPlayIconBg: 50_BLACK;
videoPlayIconFg: FG_COLOR;
toastBg: 70_BLACK;
toastFg: SELECTED_FG_COLOR;

reportSpamBg: emojiPanHeaderBg;
reportSpamFg: TERTIARY_FG_COLOR;

historyToDownBg: windowBg;
historyToDownBgOver: windowBgOver;
historyToDownBgRipple: windowBgRipple;
historyToDownFg: menuIconFg;
historyToDownFgOver: menuIconFgOver;
historyToDownShadow: 30_BLACK;

historyComposeAreaBg: BG_COLOR;
historyComposeAreaFg: FG_COLOR;                   // Text color in "Type your message" field
historyComposeAreaFgService: FG_COLOR;
historyComposeIconFg: menuIconFg;
historyComposeIconFgOver: menuIconFgOver;
historySendIconFg: SUGGESTED_COLOR;
historySendIconFgOver: SUGGESTED_ACTIVE_COLOR;
historyPinnedBg: historyComposeAreaBg;
historyReplyBg: historyComposeAreaBg;
historyReplyCancelFg: cancelIconFg;
historyReplyCancelFgOver: cancelIconFgOver;

historyComposeButtonBg: BG_COLOR;
historyComposeButtonBgOver: SEMI_FILL_COLOR;
historyComposeButtonBgRipple: FILL_COLOR;

// overview
overviewCheckBg: 30_BLACK;
overviewCheckFg: BASE_COLOR;
overviewCheckFgActive: BASE_COLOR;
overviewPhotoSelectOverlay: ACCENT_FILL_COLOR;
profileStatusFgOver: PLACEHOLDER_COLOR;

// notifications
notificationBg: DARK_COLOR;                     // Notification background
notificationsBoxMonitorFg: TERTIARY_FG_COLOR;
notificationsBoxScreenBg: imageBg;
notificationSampleUserpicFg: SECONDARY_FG_COLOR;
notificationSampleCloseFg: ACCENT_LABEL_COLOR;
notificationSampleTextFg: SECONDARY_FG_COLOR;
notificationSampleNameFg: FG_COLOR;

mainMenuBg: windowBg;                           // Left menu background (lower part, not buttons)
mainMenuCoverBg: dialogsBgActive;               // Left menu background (upper part)
mainMenuCoverFg: SELECTED_FG_COLOR;
mainMenuCloudFg: activeButtonFg;
mainMenuCloudBg: activeButtonBgRipple;

mediaPlayerBg: DARK_COLOR;                      // Music player background
mediaPlayerActiveFg: ACCENT_COLOR;              // Clickable Next song/Prev song button in music player
mediaPlayerInactiveFg: INSENSITIVE_FG_COLOR;    // "Disabled" Next song/Prev song button in music player
mediaPlayerDisabledFg: mediaPlayerInactiveFg;
mediaviewFileBg: BG_COLOR;
mediaviewFileNameFg: TERTIARY_FG_COLOR;
mediaviewFileSizeFg: mediaviewFileNameFg;
mediaviewFileRedCornerFg: RED;
mediaviewFileYellowCornerFg: YELLOW;
mediaviewFileGreenCornerFg: GREEN;
mediaviewFileBlueCornerFg: BLUE;
mediaviewFileExtFg: activeButtonFg;
mediaviewMenuBg: BG_COLOR;
mediaviewMenuBgOver: SEMI_FILL_COLOR;
mediaviewMenuBgRipple: FILL_COLOR;
mediaviewMenuFg: FG_COLOR;
mediaviewBg: DARK_COLOR;
mediaviewVideoBg: imageBg;
mediaviewControlBg: DARK_COLOR;
mediaviewControlFg: mediaviewMenuFg;
mediaviewCaptionBg: DARK_COLOR;
mediaviewCaptionFg: mediaviewControlFg;
mediaviewTextLinkFg: LINK_COLOR;
mediaviewSaveMsgBg: toastBg;
mediaviewSaveMsgFg: toastFg;
mediaviewPlaybackActive: SECONDARY_FG_COLOR;
mediaviewPlaybackInactive: INSENSITIVE_FG_COLOR;
mediaviewPlaybackActiveOver: FG_COLOR;
mediaviewPlaybackInactiveOver: INSENSITIVE_FG_COLOR;
mediaviewPlaybackProgressFg: ACCENT_COLOR;
mediaviewPlaybackIconFg: mediaviewPlaybackActive;
mediaviewPlaybackIconFgOver: mediaviewPlaybackActiveOver;
mediaviewTransparentBg: SOLID_WHITE;
mediaviewTransparentFg: PLACEHOLDER_COLOR;
